NO /Users/atuliara/Desktop/2ndtree/textures/Wood/BIGTRUNK.png
SO /Users/atuliara/Desktop/2ndtree/textures/Wood/DARKWOOD.png
WE /Users/atuliara/Desktop/2ndtree/textures/Wood/WOODA.png
EA /Users/atuliara/Desktop/2ndtree/textures/Wood/WOODTILE.png

F       220,     100,    0
C 300,255,255

11111111
10100001111
10100001
10100001
10010001
10000001
100000N1
11111111