NO ./path_to_the_north_texture
SO ./path_to_the_south_texture
WE ./path_to_the_west_texture
EA ./path_to_the_east_texture

F 220,100,0
C 225,30,0

NO /Users/ekoljone/Desktop/cub3d/textures/ball.png
SO /Users/ekoljone/Desktop/cub3d/textures/ball.png
WE /Users/ekoljone/Desktop/cub3d/textures/ball.png
EA /Users/ekoljone/Desktop/cub3d/textures/ball.png

F       220,     100,    0
C 255,255,255

11111111
10100001
10100001
10100001
10000001
1000N001
10000001
11111111