
NO /Users/atuliara/Desktop/cub3d/textures/ball.png
SO ./textures/ball_sepia.png
WE ./textures/ball_mono.png
EA ./textures/ball_neg.png

F       220,     100,    0
C 225,30,0

11111111
10100001
10100001
10100001
10000001
1000N001
10000001
11111111