NO ./textures/Bricks/CLAYBRICKS.png
SO ./textures/Bricks/REDBRICKS.png
WE ./textures/Bricks/ROUNDBRICKS.png
EA ./textures/Bricks/PORCE

F       220,     100,    0
C 300,255,255

11111111
10100000
10100001
10100001
10010001
10000001
100000N1
11111111