NO ./textures/Bricks/CLAYBRICKS.png
SO ./textures/Bricks/PORCELAINBRICKS.png
WE ./textures/Bricks/REDBRICKS.png
EA ./textures/Bricks/ROUNDBRICKS.png

F 220,220,100
C -255,30,0

111111111111111111111111111111111111111111111111111111111111111111111111111111111
100000000000000000000000000000000000000000000000000000000000000000000000000000001
1000N0000000000000000000000000000000000000000000000000000000000000000000000000001
100000000000000000000000000000000000000000000000000000000000000000000000000000001
111111111111111111110011111111111111111111111111111100111111111111111111111111111
111111111111111111110011111111111111111111111111111100000111111111111111111111111
111111111111111111110011111111111111111111111111111100000111111111111111111111111
111111111111111111110011111111111111111111111111111111100111111111111111111111111
111111111111111111110011111111111111111111111111111111100111111111111111111111111
111111111111111111110011111111111111111111111111111111100111111111111111111111111
100000000000000000000000000000000000000000000000000000000000000000000000000000001
100000000000000000000000000000000000000000000000000000000000000000000000000000001
111111111111111111111111111001111111111111111111111111111111111111111111111111111
111111111111111111111111111100111111111111111111111111111111111111111111111111111
100000001111111111111111111110011111111111111111111111111111111111111111111111111
100000001111111111111111111111001111111111111111111111111111111111111111111111111
100000001111111111111111111111100111111111111111111111111111111111111111111111111
100000000000000000000000000000000000000000000000000000000000000000000000000000001
100000000000000000000000000000000000000000000000000000000000000000000000000000001
100000000000000000000000000000000000000000000000000000000000000000000000000000001
100000000000000000000000000000000000000000000000000000000000000000000000000000001
111111111111111111111111111111111111111111111111111111111111111111111111111111001
111111111111111111111111111111111111111111111111111111111111111111111111111111001
111111111111111111111111111111111111111111111111111111111111111111111111111111001
111111111111111111111111111111111111111111111111111111111111111111111111111111001
100000000000000000000000000000000000000000000000000000000000000000000000000000001
100000000000000000000000000000000000000000000000000000000000000000000000000000001
100000000000000000000000000000000000000000000000000000000000000000000000000000001
100000000000000000000000000000000000000000000000000000000000000000000000000000001
111111111111111111111111111111111111111111111111111111111111111111111111111111111
